# Syntax Coloring Map for SkyMap Library

# Datatypes (KEYWORD1)
SKYMAP_years	KEYWORD1
SKYMAP_months	KEYWORD1
SKYMAP_days	KEYWORD1
SKYMAP_hrs	KEYWORD1
SKYMAP_rads	KEYWORD1
SKYMAP_degs	KEYWORD1
SKYMAP_date_time_values_t	KEYWORD1
SKYMAP_observer_position_t	KEYWORD1
SKYMAP_celestial_object_t	KEYWORD1
SKYMAP_star_t	KEYWORD1
SKYMAP_planet_t	KEYWORD1
SKYMAP_search_result_t	KEYWORD1
SKYMAP_skymap_t	KEYWORD1
SKYMAP_astronomical_position_t	KEYWORD1
SKYMAP_equatorial_coordinates_t	KEYWORD1
SKYMAP_local_position_t	KEYWORD1

# Functions (KEYWORD2)
SKYMAP_deg2rad	KEYWORD2
SKYMAP_rad2deg	KEYWORD2
SKYMAP_h2deg	KEYWORD2
SKYMAP_deg2h	KEYWORD2
SKYMAP_asind	KEYWORD2
SKYMAP_acosd	KEYWORD2
SKYMAP_j2000	KEYWORD2
SKYMAP_local_sidereal_time	KEYWORD2
SKYMAP_hour_angle	KEYWORD2
SKYMAP_search_for_object	KEYWORD2
SKYMAP_get_j2000	KEYWORD2
SKYMAP_get_local_sidereal_time	KEYWORD2
SKYMAP_get_hour_angle	KEYWORD2
SKYMAP_observe_object	KEYWORD2
SKYMAP_update	KEYWORD2
SKYMAP_hh_mm_ss2UTC	KEYWORD2
SKYMAP_init	KEYWORD2
SKYMAP_is_object_visible	KEYWORD2
SKYMAP_is_object_observable	KEYWORD2
SKYMAP_az_alt_to_ra_dec	KEYWORD2
SKYMAP_ra_from_lst_and_ha	KEYWORD2

# Constants (LITERAL1)
